# charPerScreen:6
--------------
-       E  O -
-      E E B -
-       E  O -
--------------
