# charPerScreen:6
--------------------
-O E              C-
-O E B             -
-   O              -
-   O              -
-O E B             -
-O E              C-
--------------------