# charPerScreen:3
--------
- E  O -
-E E B -
- E  O -
--------