# charPerScreen:105
-----------------
-ECCCCCCCCCCCCCC-
-CCCCCCCCCCCCCCC-
-ECCCCCCCCCCCCCC-
-               -
-----------------
