# charPerScreen:5
-----------------
-E              -
-EE             -
-EE             -
-EE             -
-----------------