# charPerScreen:5
-----------------
-E              -
-               -
-E              -
-               -
-----------------