# charPerScreen:5
------------
-E        E-
-EEEE  E   -
-E   B     -
-E    E   E-
------------