# charPerScreen:5
-----------------
-EE             -
-EC            -
-EE             -
-OE             -
-----------------
