# charPerScreen:105
-----------------
-               -
-D              -
-C              -
-               -
-----------------
