# charPerScreen:5
-----------------
-E              -
-          C    -
-E              -
-               -
-----------------