# charPerScreen:5
-----------------
-               -
-E              -
-  O            -
-               -
-----------------
