// speedRead:2 charPerScreen:5
----------------------------------------
-  E                                   -
-    E                                 -
-E                                     -
-  B                                   -
----------------------------------------