# charPerScreen:5
-----------------
-E          B   -
-  E    E       -
-    B      E   -
-  E    E       -
-----------------