# charPerScreen:5
-----------------
-D              -
-               -
-               -
-               -
-----------------