# charPerScreen:5
-----------------
-   C           -
-               -
-               -
-D              -
-----------------